4 4 4 4 4 4 4 1 1 1 1 1 1 1 1 1 4 4 4 4 4 4 4 4 4 4 4 4 4 1 1 1 1 1 1 1 4 4 4 4 4 4 4 4 4 4 4 4
4 0 0 0 0 0 0 1 8 8 8 8 8 8 8 1 0 0 0 0 0 0 0 0 0 1 1 1 1 1 8 8 8 8 8 1 1 1 1 1 1 1 1 1 1 0 0 4
4 0 2 2 2 0 0 1 8 8 8 8 8 8 8 1 0 0 0 2 2 2 0 0 0 1 8 8 8 1 8 1 1 1 8 8 8 8 8 8 8 8 8 8 1 0 0 4
4 0 2 5 2 0 0 1 8 8 8 8 8 8 8 1 0 0 0 2 5 2 0 0 0 1 8 1 8 1 8 1 8 8 8 8 1 1 1 1 1 1 1 8 1 0 0 4
4 0 2 2 2 0 0 1 1 1 1 6 1 1 1 1 0 0 0 2 2 2 0 1 1 1 8 1 8 1 8 1 8 1 1 1 1 0 0 0 0 0 1 8 1 0 0 4
4 0 0 0 0 0 0 0 0 0 1 7 1 0 0 0 0 0 0 0 0 0 0 1 8 8 8 1 8 8 8 1 8 8 8 1 0 0 0 0 0 0 1 8 1 0 0 4
4 0 0 0 0 0 0 0 0 0 1 7 1 0 0 0 0 0 0 0 0 0 0 1 6 1 1 1 1 1 1 1 1 1 8 1 0 0 0 1 1 1 1 6 1 1 1 4
4 0 0 0 1 1 1 1 1 1 1 7 1 1 1 1 1 1 1 0 3 3 3 3 3 0 0 0 0 1 7 7 1 8 8 1 0 0 0 1 7 7 7 7 7 7 1 4
4 0 0 0 1 7 7 7 7 7 7 7 7 7 7 7 7 7 1 0 3 0 1 1 1 1 1 1 1 1 7 7 1 1 1 1 0 0 0 1 7 7 7 7 7 7 1 4
4 0 0 0 1 7 7 7 7 7 7 7 7 7 7 7 7 7 1 0 3 0 1 8 8 8 8 8 8 1 7 7 7 7 7 1 0 0 0 1 7 7 7 7 7 7 1 4
4 0 0 0 1 7 7 7 7 7 7 7 7 7 7 7 7 7 1 0 3 0 1 8 8 11 8 8 8 1 7 7 7 7 7 1 0 0 0 1 1 1 1 9 1 1 1 4
4 0 0 0 1 1 1 1 1 1 1 9 1 1 1 1 1 1 1 0 3 0 1 8 8 8 8 8 8 1 7 7 7 7 7 1 0 0 0 0 0 0 1 8 1 0 0 4
4 0 0 0 0 0 0 0 0 0 1 8 1 0 0 0 0 0 0 0 3 0 1 8 8 8 8 8 8 1 7 7 1 9 1 1 1 1 0 0 0 0 1 8 1 0 0 4
4 0 0 0 4 4 0 0 0 0 1 8 1 0 0 0 0 3 3 3 3 0 1 1 1 1 1 6 1 1 7 7 1 8 1 8 8 1 0 0 0 0 1 8 1 0 0 4
4 0 0 4 4 0 0 0 0 0 0 3 0 0 0 0 0 3 0 0 0 0 0 0 0 0 1 7 7 7 7 7 1 8 8 8 8 1 1 0 0 0 1 8 1 0 0 4
4 0 0 4 4 4 0 0 0 0 0 3 0 0 0 0 0 3 0 0 0 0 0 0 1 1 1 1 1 1 1 1 1 8 8 8 8 8 1 0 0 0 1 8 1 0 0 4
4 0 0 0 0 4 4 0 0 0 3 3 3 0 0 0 0 3 4 0 0 0 0 0 1 8 1 8 8 8 8 8 1 8 8 1 8 8 1 0 0 0 1 8 1 0 0 4
4 0 0 0 4 4 4 0 0 0 3 3 3 3 3 3 3 3 4 0 1 1 1 1 1 8 8 8 1 1 1 8 8 8 8 8 8 8 1 1 1 0 1 8 1 0 0 4
4 0 0 4 4 4 4 4 4 4 3 3 3 4 4 3 0 0 4 0 1 7 7 7 1 1 1 1 1 8 8 8 1 8 8 8 8 8 1 8 1 0 1 8 1 0 0 4
4 0 0 4 4 4 0 0 0 0 4 4 4 0 4 3 0 0 4 0 1 7 12 7 1 8 1 8 1 8 1 8 1 8 8 8 8 1 8 8 1 1 1 8 1 0 0 4
4 0 0 4 4 4 4 4 0 0 0 0 0 0 4 3 0 0 4 0 1 7 7 7 1 8 8 8 1 1 1 8 1 1 1 8 1 8 8 8 8 8 8 8 1 0 0 4
4 0 0 0 0 4 4 4 0 0 4 4 0 0 4 3 0 4 4 0 1 1 9 1 1 1 1 8 8 8 8 8 1 8 1 8 1 1 1 8 1 1 1 1 1 0 0 4
4 0 0 0 0 0 4 4 4 4 4 4 4 0 4 3 0 0 0 0 0 1 8 8 8 8 1 8 1 8 1 8 1 8 1 8 8 8 8 8 1 0 0 0 0 0 0 4
4 0 0 0 0 0 0 0 0 4 4 4 0 0 4 3 0 0 0 0 0 1 1 1 1 8 1 8 1 8 1 8 1 8 1 1 1 8 8 1 1 0 0 0 0 0 0 4
4 0 0 0 1 1 1 1 1 4 0 0 0 0 4 3 0 0 0 0 0 0 0 0 1 8 1 1 1 1 1 1 1 8 8 8 8 8 8 1 0 0 0 0 0 0 0 4
4 0 0 0 1 8 8 8 1 4 0 3 3 3 3 3 0 0 0 0 0 0 0 0 1 8 8 8 8 8 8 8 8 1 8 1 8 1 8 1 0 0 0 0 0 0 0 4
4 0 0 0 1 8 8 8 1 4 0 3 0 0 0 0 0 0 0 0 0 0 0 0 1 1 1 1 1 1 1 1 8 8 8 8 8 1 8 1 0 0 0 0 0 0 0 4
4 0 0 0 1 1 6 1 1 4 0 3 0 0 0 0 0 0 0 0 0 0 0 0 0 0 0 0 0 0 0 0 1 1 1 1 1 0 1 0 0 0 0 0 0 0 0 4
4 0 0 0 0 0 3 0 0 0 0 3 0 0 0 0 0 0 0 0 0 0 0 0 0 0 0 0 0 0 0 0 0 0 0 0 0 0 0 0 0 0 0 0 0 0 0 4
4 0 0 0 0 0 3 3 3 3 3 3 0 0 0 0 0 0 0 0 0 0 0 0 0 0 0 0 0 0 0 0 0 0 0 0 0 0 0 0 0 0 0 0 0 0 0 4
4 0 0 0 0 0 0 0 0 0 0 0 0 0 0 0 0 0 0 0 0 0 0 0 0 0 0 0 0 0 0 0 0 0 0 0 0 0 0 0 0 0 0 0 0 0 0 4
4 4 4 4 4 4 4 4 4 4 4 4 4 4 4 4 4 4 4 4 4 4 4 4 4 4 4 4 4 4 4 4 4 4 4 4 4 4 4 4 4 4 4 4 4 4 4 4